"","GEOID","B07204_001","B07204_002","B07204_003","B07204_004","B07204_005","B07204_006","B07204_007","B07204_008","B07204_009","B07204_010","B07204_011","B07204_012","B07204_013","B07204_014","B07204_015","B07204_016","B07204_017","B07204_018","B07204_019"
"Newberry County School District, South Carolina","4503030",37468,33793,3585,580,580,0,3005,1605,1400,988,412,68,11,333,0,90,2,0,88
"Oconee County School District, South Carolina","4503060",75190,64936,10141,688,688,0,9453,4575,4878,2834,2044,335,229,1308,172,113,0,0,113
"Marlboro County School District, South Carolina","4502970",27199,24234,2903,425,425,0,2478,1122,1356,777,579,43,19,493,24,62,19,0,43
"McCormick County School District, South Carolina","4503000",9654,8466,1166,51,51,0,1115,236,879,648,231,58,30,142,1,22,4,0,18
"Orangeburg School District 3, South Carolina","4503150",19611,17794,1807,104,104,0,1703,1160,543,403,140,11,0,70,59,10,0,0,10
"Orangeburg School District 4, South Carolina","4503180",19369,17935,1434,80,80,0,1354,1182,172,126,46,0,0,45,1,0,0,0,0
"Orangeburg School District 5, South Carolina","4503210",49319,44048,5031,981,981,0,4050,1798,2252,1597,655,44,51,527,33,240,103,0,137
"Pickens County School District, South Carolina","4503330",120142,96435,23191,2727,2705,22,20464,8007,12457,8094,4363,624,526,2937,276,516,0,24,492
"Richland School District 1, South Carolina","4503360",200779,149832,49255,11007,10984,23,38248,14841,23407,14299,9108,1930,750,5773,655,1692,3,16,1673
"Richland School District 2, South Carolina","4503390",135962,115912,19250,698,698,0,18552,10868,7684,3727,3957,575,685,1901,796,800,0,0,800
"Spartanburg School District 3, South Carolina","4503540",15422,13345,2056,108,108,0,1948,1162,786,274,512,258,138,116,0,21,0,0,21
"Saluda County School District, South Carolina","4503460",15397,14542,767,67,67,0,700,375,325,117,208,0,0,192,16,88,0,0,88
"Spartanburg School District 1, South Carolina","4503480",29674,26372,3279,101,101,0,3178,2091,1087,595,492,32,22,394,44,23,0,0,23
"Spartanburg School District 2, South Carolina","4503510",59082,51662,7098,411,411,0,6687,4003,2684,1455,1229,223,64,825,117,322,112,0,210
"Spartanburg School District 4, South Carolina","4503570",19867,16053,3777,407,407,0,3370,1606,1764,1241,523,69,52,391,11,37,0,0,37
"Spartanburg School District 5, South Carolina","4503600",45051,38726,6243,244,223,21,5999,3398,2601,1160,1441,300,189,848,104,82,0,0,82
"Spartanburg School District 6, South Carolina","4503630",66076,54678,11229,1393,1393,0,9836,6578,3258,1713,1545,176,87,1120,162,169,15,0,154
"Spartanburg School District 7, South Carolina","4503660",50956,41500,9337,2191,2191,0,7146,3944,3202,1837,1365,194,145,806,220,119,2,0,117
"Union County School District, South Carolina","4503750",27472,24131,3312,1008,1008,0,2304,1355,949,892,57,12,3,19,23,29,0,0,29
"Williamsburg County School District, South Carolina","4503780",32046,29358,2496,149,149,0,2347,1291,1056,785,271,47,11,213,0,192,13,0,179
"York School District 1, South Carolina","4503810",32197,29339,2840,421,421,0,2419,1289,1130,235,895,194,166,529,6,18,0,0,18
"York School District 2, South Carolina","4503840",39641,33735,5761,635,635,0,5126,2130,2996,458,2538,208,465,1731,134,145,1,0,144
"York School District 3, South Carolina","4503870",115074,97195,17575,5441,5441,0,12134,5222,6912,4082,2830,559,248,1883,140,304,0,0,304
"York School District 4, South Carolina","4503900",61747,51330,10049,994,994,0,9055,3086,5969,1299,4670,744,241,2924,761,368,0,0,368
"Remainder of South Carolina, South Carolina","4599999",17248,3446,13535,187,187,0,13348,320,13028,520,12508,1916,2295,5550,2747,267,131,25,111
"Dillon School District 4, South Carolina","4501920",23400,20931,2426,221,221,0,2205,1336,869,514,355,38,0,317,0,43,0,0,43
"Marion School District 10, South Carolina","4503908",31390,28323,2769,444,444,0,2325,1305,1020,409,611,152,8,301,150,298,0,0,298
"Sumter County Consolidated School District, South Carolina","4503902",105784,89421,15627,3652,3652,0,11975,6269,5706,2401,3305,620,418,1793,474,736,0,43,693
"Aiken County School District, South Carolina","4500720",166244,144534,21313,4131,4115,16,17182,9125,8057,2698,5359,727,681,3544,407,397,1,0,396
"Anderson School District 1, South Carolina","4500780",52940,47062,5701,99,99,0,5602,2349,3253,2121,1132,27,33,924,148,177,0,0,177
"Dorchester School District 4, South Carolina","4500002",17938,16174,1764,43,43,0,1721,907,814,648,166,0,72,36,58,0,0,0,0
"Abbeville County School District, South Carolina","4500690",23331,20831,2482,482,482,0,2000,529,1471,1120,351,6,50,295,0,18,0,0,18
"Allendale County School District, South Carolina","4500750",9359,8367,992,286,286,0,706,0,706,600,106,0,0,106,0,0,0,0,0
"Anderson School District 2, South Carolina","4500810",22672,19922,2718,316,316,0,2402,1166,1236,789,447,73,78,202,94,32,0,0,32
"Anderson School District 3, South Carolina","4500840",14523,12926,1563,24,24,0,1539,944,595,194,401,0,16,340,45,34,0,0,34
"Anderson School District 4, South Carolina","4500870",21030,18078,2922,15,15,0,2907,1023,1884,1215,669,112,45,412,100,30,0,0,30
"Bamberg School District 2, South Carolina","4500960",6571,6072,499,44,44,0,455,54,401,178,223,21,0,202,0,0,0,0,0
"Barnwell School District 45, South Carolina","4501080",12023,10489,1506,410,410,0,1096,632,464,177,287,42,0,245,0,28,0,0,28
"Anderson School District 5, South Carolina","4500900",80856,68384,12205,2248,2248,0,9957,6608,3349,1785,1564,261,421,782,100,267,4,0,263
"Bamberg School District 1, South Carolina","4500930",8117,7412,694,34,34,0,660,201,459,349,110,38,8,64,0,11,0,0,11
"Barnwell School District 19, South Carolina","4501020",4729,4215,507,10,10,0,497,323,174,97,77,0,0,77,0,7,0,0,7
"Barnwell School District 29, South Carolina","4501050",4770,4046,724,8,8,0,716,110,606,393,213,0,69,144,0,0,0,0,0
"Calhoun County School District, South Carolina","4501250",14726,13919,807,37,37,0,770,274,496,383,113,29,8,76,0,0,0,0,0
"Beaufort County School District, South Carolina","4501110",176812,143423,32327,4086,4086,0,28241,11224,17017,2821,14196,3094,2105,7232,1765,1062,5,0,1057
"Berkeley County School District, South Carolina","4501170",201889,168913,32268,3320,3197,123,28948,9549,19399,8964,10435,1434,1351,5248,2402,708,50,14,644
"Charleston County School District, South Carolina","4501440",382933,320011,61502,20714,20506,208,40788,14941,25847,11200,14647,3198,2327,7626,1496,1420,8,40,1372
"Cherokee County School District, South Carolina","4501500",54312,48289,5925,869,869,0,5056,2905,2151,1401,750,73,35,618,24,98,0,12,86
"Chester County School District, South Carolina","4501530",31922,30043,1850,257,257,0,1593,643,950,674,276,19,7,203,47,29,0,0,29
"Chesterfield County School District, South Carolina","4501560",45723,40997,4637,988,988,0,3649,1622,2027,1275,752,154,1,576,21,89,0,0,89
"Clarendon School District 1, South Carolina","4501740",8343,7611,721,28,28,0,693,442,251,180,71,11,9,51,0,11,0,0,11
"Clarendon School District 2, South Carolina","4501770",18473,16590,1838,157,157,0,1681,839,842,499,343,12,0,309,22,45,0,0,45
"Clarendon School District 3, South Carolina","4501800",6976,6267,684,53,53,0,631,85,546,441,105,0,0,105,0,25,0,0,25
"Colleton County School District, South Carolina","4501830",37272,33951,3315,255,255,0,3060,1526,1534,947,587,69,16,475,27,6,0,0,6
"Dillon School District 3, South Carolina","4501950",7270,6719,551,17,17,0,534,446,88,65,23,0,0,23,0,0,0,0,0
"Darlington County School District, South Carolina","4501860",66802,58759,7997,744,744,0,7253,3500,3753,2871,882,176,110,579,17,46,0,4,42
"Dorchester School District 2, South Carolina","4502010",132132,110109,21374,3323,3074,249,18051,5989,12062,7355,4707,719,704,2652,632,649,0,0,649
"Edgefield County School District, South Carolina","4502070",26497,22941,3458,530,530,0,2928,681,2247,1510,737,130,49,497,61,98,80,0,18
"Fairfield County School District, South Carolina","4502100",22760,21590,1086,66,66,0,1020,613,407,253,154,1,0,153,0,84,5,0,79
"Florence School District 1, South Carolina","4502130",98390,85369,12917,2231,2231,0,10686,6007,4679,3005,1674,485,294,740,155,104,1,0,103
"Florence School District 2, South Carolina","4502160",7192,6698,494,26,26,0,468,296,172,54,118,0,5,113,0,0,0,0,0
"Georgetown County School District, South Carolina","4502280",60599,53528,7019,936,936,0,6083,2454,3629,1969,1660,503,292,800,65,52,2,0,50
"Florence School District 3, South Carolina","4502190",19364,16954,2395,180,180,0,2215,1809,406,336,70,0,15,43,12,15,0,0,15
"Florence School District 4, South Carolina","4502220",6376,5797,563,98,98,0,465,265,200,188,12,12,0,0,0,16,0,0,16
"Florence School District 5, South Carolina","4502250",5283,4822,461,54,54,0,407,355,52,45,7,5,0,2,0,0,0,0,0
"Greenville County School District, South Carolina","4502310",499785,425538,70452,8957,8691,266,61495,33221,28274,12333,15941,3041,2520,8897,1483,3795,187,8,3600
"Greenwood School District 50, South Carolina","4502340",57751,48974,8713,1732,1732,0,6981,3641,3340,1981,1359,292,129,870,68,64,0,0,64
"Greenwood School District 51, South Carolina","4502370",6819,5846,973,29,26,3,944,62,882,764,118,7,8,103,0,0,0,0,0
"Horry County School District, South Carolina","4502490",307568,258379,47985,5034,5034,0,42951,23570,19381,4517,14864,5134,1648,7716,366,1204,87,0,1117
"Greenwood School District 52, South Carolina","4502400",7897,7172,725,45,45,0,680,361,319,150,169,49,4,116,0,0,0,0,0
"Hampton School District 1, South Carolina","4502430",12298,11579,719,299,299,0,420,220,200,96,104,0,49,17,38,0,0,0,0
"Hampton School District 2, South Carolina","4502460",7604,6688,888,284,284,0,604,158,446,78,368,32,26,286,24,28,0,0,28
"Jasper County School District, South Carolina","4502520",27158,23702,3428,316,316,0,3112,850,2262,1289,973,226,49,635,63,28,0,0,28
"Kershaw County School District, South Carolina","4502550",63030,58310,4456,305,305,0,4151,2309,1842,985,857,169,117,495,76,264,124,0,140
"Lancaster County School District, South Carolina","4502580",85557,75621,9709,953,953,0,8756,4269,4487,1525,2962,495,178,2186,103,227,2,11,214
"Laurens School District 55, South Carolina","4502610",36440,31027,5395,1019,1019,0,4376,2496,1880,1568,312,208,11,93,0,18,0,0,18
"Laurens School District 56, South Carolina","4502640",21313,17878,3323,897,897,0,2426,1204,1222,912,310,37,3,230,40,112,0,0,112
"Lee County School District, South Carolina","4502670",17717,16421,1290,46,46,0,1244,448,796,689,107,33,43,23,8,6,0,0,6
"Lexington School District 1, South Carolina","4502700",134473,115786,17918,1107,1107,0,16811,9768,7043,4234,2809,765,353,1572,119,769,0,101,668
"Lexington School District 2, South Carolina","4502730",63823,52729,10759,1150,1150,0,9609,4512,5097,3143,1954,366,472,964,152,335,3,16,316
"Lexington School District 3, South Carolina","4502760",13601,11725,1841,703,681,22,1138,409,729,398,331,67,0,162,102,35,0,11,24
"Lexington School District 4, South Carolina","4502790",18165,16256,1909,7,7,0,1902,1339,563,330,233,55,19,159,0,0,0,0,0
"Lexington School District 5, South Carolina","4502820",97740,85704,11791,623,623,0,11168,3476,7692,4778,2914,606,367,1698,243,245,0,0,245
